....................|..|........
..............<-----...|<------|
<-|...........|........||......|
|.|...........|........||......|
|.|<---|......|..<-----.|......|
|.||...|......|..|......|......|
|.||...|...<--...--|....|......|
|.-....----........|....----|..|
|..................|........|..|
|..................|........|..|
---|...<---|.......--------||..|
...|...|...|..s............||..|
...|...|...|...............||..|
...----....|.......<----|..||..|
...........|.......|....|..||..|
.<--------||.......|....|..-...|
.|........||.......|....|......|
.|........||.......|....|......|
.|........|----|..<.....|..<---.
.|........|....|..|.....|..|....
.|........|....|..|.....|..|....
.|........|....|..|.....|..|....
.|........-----...|.....|..|....
.|................|..<--...--|..
.|................|..|.......|..
.--|...<----------...|.......|..
...|...|.............|.......|..
...|...|.............|.......|..
...|...--------------........|..
...|.........................|..
...|.........................|..
...--------------------------...
