,,,,,,,,,,,,,,,,,,,,,,,,,,,,,,,,
,,,,,,,,,,,,,,,,,,,,,,,,,,,,,,,,
,,,,,,,,,,,,,,,,,,,,,,,,,,,,,,,,
,,,,,,,,<-----|,,,,<----|,,<---|
,,,,,,,,|.....|,,,,|....---....|
,,,,,,,,|.....|,,,,|.<|.....s..|
<-----|,|.....|,,,,|.-.........|
|.....|,|.....|,,,,|....<--|...|
|.....|,|.....|,,,,|./\.|,,|...|
---|..|,|.....|,,,,|.\/.|,,|...|
,,,|..|,|.....|,,,,|....|,,|...|
,,,|..|,|.....|,,,,|....|,,|...|
,,,|..|,|.....|,,,,|....|,,|...|
,,,|..|,|.....|,,,,|....|,,|...|
,,,|..|,|.....|,,,,|....|,,|...|
,,,|..|,|.....|,,,,|....|,,|...|
,,,|..|,|.....|,,,,|....|,,|...|
,,,|..|,|.....|,,,,|....|,,|...|
,,,|..|,|.....|,,,,|....|,,|...|
,,,|..|,|.....|,,,,|....|,,|...|
,,,|..|,|.....|,,,,|....|,,|...|
,,,|..|,|.....|,,,,|....|,,|...|
,,,|..|,|.....-----.....|,,|...|
,,,|..|,|...............|,,|...|
,,,|..|,|...............|,,|...|
,,,|..|,----------------,,,|...|
,,,|..|,,,,,,,,,,,,,,,,,,,,|...|
,,,|..|,,,,,,,,,,,,,,,,,,,,|...|
,,,|..---------------------....|
,,,|...........................|
,,,|...........................|
,,,----------------------------,
