,III...ISSSI,,,,,/-----------|,,
,IMI...I000I,,,,,|...........|,,
,IMIIIII===|,,,,,|...........|,,
<.R...IIFFFIP|,,/............|,,
|............---.............|,,
|............................|,,
|............................|,,
|..........n.................|,,
|............................|,,
|............................\,,
II...........................1X,
I/.........................e.1X,
X2...........................1X,
X2.........................../,,
X2..s........................|,,
-\...........................|,,
,I...........................|,,
,|...........................|,,
,|...........................|,,
,|...........................|,,
,|...........................|,,
,|...........................|,,
,|...........................|,,
,\...........................|,,
,,---------------------------,,,
,,,,,,,,,,,,,,IEEEEEEEEEEI,,,,,,
,,,,,,,,,,,,,,,DDDDDDDDDDD,,,,,,
,,,,,,,,,,,,,,,,,,,,,,,,,,,,,,,,
,,,,,,,_,,,,,,,,,,,,,,,,,,,,,,,,
,,,,,,,,,,,,,,,,CL,,,,,,,,,,,,,,
,,,,,,,,,,,,,,,,,,,,,,,,,,,,,,,,
,,,,,,,,,,,,,,,,,,,,,,,,,,,,,,,,
